     #####                                          #######
     #···##########                          ########·····#     ###     ####
     #············#                          #············#######·#######··#
     #···########·#                          ########······················#
     ###·#      #·#        ########                 #·###########·########·#
       #·#      #·#        #······#                 #·#         ###      #·#
       #·#      #·#        #······#                 #·#                  #·#
       #·#      #·##########······#                 #·#        #######   #·#
       #·#      #·················#                 #·#      ###·····#   #·#
       #·#      #·##########······#                 #·#      #·······#  ##·#
       #·#      #·#        #······#                 #·#   ######·····#  #··#
       #·#      ###        ####·###         #########·#   #·#  #·····####··#
       #·#                    #·#           #·········#####·#  #···········#
       #·#                    #·#           #########·······#  #·····####··#
       #·###         #█#      #·#                   #·#####·#  #####·#  #··#
       #···###########·#      #·#                   #·#   #·#      #·#  ##·#
       #···············#     ##·#############       #·#   #·#      #·#   ###
 #######···###########·#     #··············#       #·#   ###     ##·#####
 #·········#         #·#     #····#######·###       #·#    ########······#
 #######···#         #·#     ######     #·#         #·#    #·············#
       ##·##         ###                #·#       ###·#### ########······#
        #·#                             #·#########······#        #······#
        #·#                             #················#        ######·#
        #·#        ###                  #·#########······#             #·#
    #####·##########·###                #·#       #······#             ###
    #··················#                #·#       ########
    ####################                #·#
                                        ###

